ERS2.0 header description from:

Butterweck, G., Bucher, B., Gryc, L., Debayle, C., Strobl, C.,  Maillard, S., Thomas, M., Helbig, A., Krol, I., Chuzel, S., Couvez, C., Ohera, M., Rybach, L., Poretti, C.,  Hofstetter-Boillat, B., Mayer, S., Scharding, G.: International Intercomparison Exercise of Airborne Gamma-Spectrometric Systems of the Czech Republic, France, Germany and Switzerland in the Framework of the Swiss Exercise ARM17. PSI-Report No. 18-04, ISSN 1019-0643, Paul Scherrer Institut, Villigen, Switzerland, 2018.

available here:

https://www.researchgate.net/publication/330482739_International_Intercomparison_Exercise_of_Airborne_Gamma-Spectrometric_Systems_of_the_Czech_Republic_France_Germany_and_Switzerland_in_the_Framework_of_the_Swiss_Exercise_ARM17

Header data:

General header information

Header identifier H:

HCTRY - Country - Text

HORG - Organisation - Text

HMODE - Operational mode. Values are REAL, EXERCISE or TRAINING - Text

HTEAM - Team - Text

HSITE - Site (can be used to describe part of a survey) - Text

HFILE - File name or other code - Text

HSW - Identification of software used for evaluation - Text

HSURVEY - Survey information: should include information about survey name, aimed ground clearance,aimed line spacing, speed, etc.) - Text

HTZ - Time zone. Specifies the difference of the time used to UTC - h


Header identifier IA:

IA(sysid) - Instrumentation, apparatus 

sysid - system identification is optional. The third character in the code for instrumentation is the same as the EURDEP code for apparatus type 
Common types are given here
Value should describe the apparatus
Can be combined with the _D identifier tail

IAB - Alpha - ZnS scintillator - Text

IAD - Alpha - solid state detector - Text

IAY - Alpha - alpha spectrometry - Text

IAE - Alpha - other - Text

IAG - Beta - Geiger-Muller counter - Text

IAJ - Beta - solid state detector - Text

IAK - Beta - other - Text

IAM - Beta and gamma - other - Text

IA1 - Gamma - Geiger-Muller tube - Text

IAN - Gamma - TLD - Text

IAO - Gamma - ionisation chamber - Text

IAP - Gamma - sodium iodide detector - Text

IAU - Gamma - gamma spectrometry scintillator - Text

IAQ - Gamma - solid state detector, Ge(Li) or HPGe - Text

IAR - Gamma - other - Text

IAZ - Other - Text
